A.ADM1	första ordningens administrativ avdelning	a primary administrative division of a country, such as a state in the United States
A.ADM1H	historical first-order administrative division	a former first-order administrative division
A.ADM2	andra ordningens administrativ avdelning	a subdivision of a first-order administrative division
A.ADM2H	historical second-order administrative division	a former second-order administrative division
A.ADM3	tredje ordningens administrativ avdelning	a subdivision of a second-order administrative division
A.ADM3H	historical third-order administrative division	a former third-order administrative division
A.ADM4	fjärde ordningens administrativ avdelning	a subdivision of a third-order administrative division
A.ADM4H	historical fourth-order administrative division	a former fourth-order administrative division
A.ADM5	fifth-order administrative division	a subdivision of a fourth-order administrative division
A.ADMD	administrativ avdelning	an administrative division of a country, undifferentiated as to administrative level
A.ADMDH	historical administrative division 	a former administrative division of a political entity, undifferentiated as to administrative level
A.LTER	uthyrt område	a tract of land leased to another country, usually for military installations
A.PCL	politisk enhet	
A.PCLD	beroende politisk enhet	
A.PCLF	fritt associerad stat	
A.PCLH	historical political entity	a former political entity
A.PCLI	oberoende politisk enhet	
A.PCLIX	del av oberoende politisk enhet	
A.PCLS	delvis oberoende politisk enhet	
A.PRSH	kommun	an ecclesiastical district
A.TERR	territorium	
A.ZN	zon	
A.ZNB	bufferzon	a zone recognized as a buffer between two nations in which military presence is minimal or absent
H.AIRS	landningsplats för sjöflygplan	a place on a waterbody where floatplanes land and take off
H.ANCH	ankarplats	an area where vessels may anchor
H.BAY	vik, bukt	a coastal indentation between two capes or headlands, larger than a cove but smaller than a gulf
H.BAYS	vikar, bukter	coastal indentations between two capes or headlands, larger than a cove but smaller than a gulf
H.BGHT	bukt(er)	an open body of water forming a slight recession in a coastline
H.BNK	strandssluttning, strandvall	an elevation, typically located on a shelf, over which the depth of water is relatively shallow but sufficient for most surface navigation
H.BNKR	flodstrand	a sloping margin of a stream channel which normally confines the stream to its channel on land
H.BNKX	del av flodstrand	
H.BOG	kärr, träsk	a wetland characterized by peat forming sphagnum moss, sedge, and other acid-water plants
H.CAPG	iskalott	a dome-shaped mass of glacial ice covering an area of mountain summits or other high lands; smaller than an ice sheet
H.CHN	kanal	the deepest part of a stream, bay, lagoon, or strait, through which the main current flows
H.CHNL	sjökanal(er)	that part of a lake having water deep enough for navigation between islands, shoals, etc.
H.CHNM	marinkanal	that part of a body of water deep enough for navigation through an area otherwise not suitable
H.CHNN	navigeringskanal	a buoyed channel of sufficient depth for the safe navigation of vessels
H.CNFL	sammanflöde	a place where two or more streams or intermittent streams flow together
H.CNL	kanal	an artificial watercourse
H.CNLA	akvedukt	a conduit used to carry water
H.CNLB	kanalkrök	a conspicuously curved or bent section of a canal
H.CNLD	dräneringskanal	an artificial waterway carrying water away from a wetland or from drainage ditches
H.CNLI	bevattningskanal	a canal which serves as a main conduit for irrigation water
H.CNLN	navigeringskanaler	a watercourse constructed for navigation of vessels
H.CNLQ	övergiven kanal	
H.CNLSB	underjordisk bevattningskanal(er)	a gently inclined underground tunnel bringing water for irrigation from aquifers
H.CNLX	del av kanal	
H.COVE	liten vik	a small coastal indentation, smaller than a bay
H.CRKT	tidvattensvik(ar)	a meandering channel in a coastal wetland subject to bi-directional tidal currents
H.CRNT	ström, strömning	a horizontal flow of water in a given direction with uniform velocity
H.CUTF	cutoff	a channel formed as a result of a stream cutting through a meander neck
H.DCK	skeppsdocka	a waterway between two piers, or cut into the land for the berthing of ships
H.DCKB	fartygsdocka	a part of a harbor where ships dock
H.DOMG	välvd iskalott	a comparatively elevated area on an icecap
H.DPRG	sänka i iskalott	a comparatively depressed area on an icecap
H.DTCH	dike	a small artificial watercourse dug for draining or irrigating the land
H.DTCHD	dräneringsdike	a ditch which serves to drain the land
H.DTCHI	bevattningsdike	a ditch which serves to distribute irrigation water
H.DTCHM	dikesmynning	an area where a drainage ditch enters a lagoon, lake or bay
H.ESTY	flodmynning	a funnel-shaped stream mouth or embayment where fresh water mixes with sea water under tidal influences
H.FISH	fiskeområde	a fishing ground, bank or area where fishermen go to catch fish
H.FJD	fjord	a long, narrow, steep-walled, deep-water arm of the sea at high latitudes, usually along mountainous coasts
H.FJDS	fjordar	long, narrow, steep-walled, deep-water arms of the sea at high latitudes, usually along mountainous coasts
H.FLLS	vattenfall	a perpendicular or very steep descent of the water of a stream
H.FLLSX	del av vattenfall	
H.FLTM	mud flat(s)	a relatively level area of mud either between high and low tide lines, or subject to flooding
H.FLTT	tidal flat(s)	a large flat area of mud or sand attached to the shore and alternately covered and uncovered by the tide
H.GLCR	glaciär(er)	a mass of ice, usually at high latitudes or high elevations, with sufficient thickness to flow away from the source area in lobes, tongues, or masses
H.GULF	golf, bukt	a large recess in the coastline, larger than a bay
H.GYSR	geyser	a type of hot spring with intermittent eruptions of jets of hot water and steam
H.HBR	hamn(ar)	a haven or space of deep water so sheltered by the adjacent land as to afford a safe anchorage for ships
H.HBRX	del av hamn	
H.INLT	vik, sund	a narrow waterway extending into the land, or connecting a bay or lagoon with a larger body of water
H.INLTQ	tidigare vik	an inlet which has been filled in, or blocked by deposits
H.LBED	sjöbotten	a dried up or drained area of a former lake
H.LGN	lagun	a shallow coastal waterbody, completely or partly separated from a larger body of water by a barrier island, coral reef or other depositional feature
H.LGNS	laguner	shallow coastal waterbodies, completely or partly separated from a larger body of water by a barrier island, coral reef or other depositional feature
H.LGNX	del av lagun	
H.LK	sjö	a large inland body of standing water
H.LKC	kratersjö	a lake in a crater or caldera
H.LKI	periodisk sjö	
H.LKN	saltsjö	an inland body of salt water with no outlet
H.LKNI	periodisk saltsjö	
H.LKO	uformad sjö	a crescent-shaped lake commonly found adjacent to meandering streams
H.LKOI	peridodisk uformad sjö	
H.LKS	sjöar	large inland bodies of standing water
H.LKSB	underjordisk sjö	a standing body of water in a cave
H.LKSC	kratersjöar	lakes in a crater or caldera
H.LKSI	periodiska sjöar	
H.LKSN	saltsjöar	inland bodies of salt water with no outlet
H.LKSNI	periodiska saltsjöar	
H.LKX	del av sjö	
H.MFGN	saltdammar	diked salt ponds used in the production of solar evaporated salt
H.MGV	mangroveträsk	a tropical tidal mud flat characterized by mangrove vegetation
H.MOOR	hed(ar) 	an area of open ground overlaid with wet peaty soils
H.MRSH	moras, sumpmark	a wetland dominated by grass-like vegetation
H.MRSHN	salt sumpmark	a flat area, subject to periodic salt water inundation, dominated by grassy salt-tolerant plants
H.NRWS	trångt sund	a navigable narrow part of a bay, strait, river, etc.
H.OCN	hav	one of the major divisions of the vast expanse of salt water covering part of the earth
H.OVF	vattenfall	an area of breaking waves caused by the meeting of currents or by waves moving against the current
H.PND	damm	a small standing waterbody
H.PNDI	periodisk damm	
H.PNDN	saltdamm	a small standing body of salt water often in a marsh or swamp, usually along a seacoast
H.PNDNI	periodiska saltdammar	
H.PNDS	dammar	small standing waterbodies
H.PNDSF	fiskdammar	ponds or enclosures in which fish are kept or raised
H.PNDSI	periodiska dammar	
H.PNDSN	saltdammar	small standing bodies of salt water often in a marsh or swamp, usually along a seacoast
H.POOL	pöl, damm, pool	a small and comparatively still, deep part of a larger body of water such as a stream or harbor; or a small body of standing water
H.POOLI	peridodisk pool	
H.RCH	utvidgning	a straight section of a navigable stream or channel between two bends
H.RDGG	iskalottsfåra	a linear elevation on an icecap
H.RDST	redd	an open anchorage affording less protection than a harbor
H.RF	rev	a surface-navigation hazard composed of consolidated material
H.RFC	korallrev	a surface-navigation hazard composed of coral
H.RFX	del av rev	
H.RPDS	forsar	a turbulent section of a stream associated with a steep, irregular stream bed
H.RSV	reservoar	an artificial pond or lake
H.RSVI	periodisk reservoar	
H.RSVT	vattentank	a contained pool or tank of water at, below, or above ground level
H.RVN	ravin(er)	a small, narrow, deep, steep-sided stream channel, smaller than a gorge
H.SBKH	sabkha	a salt flat or salt encrusted plain subject to periodic inundation from flooding or high tides
H.SD	sund	a long arm of the sea forming a channel between the mainland and an island or islands; or connecting two larger bodies of water
H.SEA	hav	a large body of salt water more or less confined by continuous land or chains of islands forming a subdivision of an ocean
H.SHOL	grund, rev	a surface-navigation hazard composed of unconsolidated material
H.SILL	tröskel	the low part of an underwater gap or saddle separating basins, including a similar feature at the mouth of a fjord
H.SPNG	källa(or)	a place where ground water flows naturally out of the ground
H.SPNS	svavelkälla(or)	a place where sulphur ground water flows naturally out of the ground
H.SPNT	varmkälla (or)	a place where hot ground water flows naturally out of the ground
H.STM	å, bäck, ström	a body of running water moving to a lower level in a channel on land
H.STMA	bifurkation	a diverging branch flowing out of a main stream and rejoining it downstream
H.STMB	åkrök	a conspicuously curved or bent segment of a stream
H.STMC	kanaliserat vattendrag	a stream that has been substantially ditched, diked, or straightened
H.STMD	biflod(er)	a branch which flows away from the main stream, as in a delta or irrigation canal
H.STMH	källfloder	the source and upper part of a stream, including the upper drainage basin
H.STMI	periodiskt vattendrag	
H.STMIX	del av periodiskt vattendrag	
H.STMM	åmynning(ar)	a place where a stream discharges into a lagoon, lake, or the sea
H.STMQ	övergivet vattendrag	a former stream or distributary no longer carrying flowing water, but still evident due to lakes, wetland, topographic or vegetation patterns
H.STMS	vattendrag	bodies of running water moving to a lower level in a channel on land
H.STMSB	lost river	a surface stream that disappears into an underground channel, or dries up in an arid area
H.STMX	del av vattendrag	
H.STRT	sund	a relatively narrow waterway, usually narrower and less extensive than a sound, connecting two larger bodies of water
H.SWMP	träsk, sumpmark, kärr	a wetland dominated by tree vegetation
H.SYSI	bevattningssystem	a network of ditches and one or more of the following elements: water supply, reservoir, canal, pump, well, drain, etc.
H.TNLC	canal tunnel	a tunnel through which a canal passes
H.WAD	flod	a valley or ravine, bounded by relatively steep banks, which in the rainy season becomes a watercourse; found primarily in North Africa and the Middle East
H.WADB	flodkrök	a conspicuously curved or bent segment of a wadi
H.WADJ	flodförbindning	a place where two or more wadies join
H.WADM	flodmynning	the lower terminus of a wadi where it widens into an adjoining floodplain, depression, or waterbody
H.WADS	floder	valleys or ravines, bounded by relatively steep banks, which in the rainy season become watercourses; found primarily in North Africa and the Middle East
H.WADX	del av flod	
H.WHRL	virvel	a turbulent, rotating movement of water in a stream
H.WLL	brunn, källa	a cylindrical hole, pit, or tunnel drilled or dug down to a depth from which water, oil, or gas can be pumped or brought to the surface
H.WLLQ	övergiven källa	
H.WLLS	källor	cylindrical holes, pits, or tunnels drilled or dug down to a depth from which water, oil, or gas can be pumped or brought to the surface
H.WTLD	våtmark	an area subject to inundation, usually characterized by bog, marsh, or swamp vegetation
H.WTLDI	periodisk våtmark	
H.WTRC	vattendrag	a natural, well-defined channel produced by flowing water, or an artificial channel designed to carry flowing water
H.WTRH	vattenhål	a natural hole, hollow, or small depression that contains water, used by man and animals, especially in arid areas
L.AGRC	jordbrukskoloni	a tract of land set aside for agricultural settlement
L.AMUS	nöjespark	Amusement Park are theme parks, adventure parks offering entertainment, similar to funfairs but with a fix location
L.AREA	area, område	a tract of land without homogeneous character or boundaries
L.BSND	vattenuppsamlingsområde	an area drained by a stream
L.BSNP	råoljebassäng	an area underlain by an oil-rich structural basin
L.BTL	slagfält	a site of a land battle of historical importance
L.CLG	uthuggning, röjt område	an area in a forest with trees removed
L.CMN	allmänt område	a park or pasture for community use
L.CNS	koncessionsområde	a lease of land by a government for economic development, e.g., mining, forestry
L.COLF	kolfält	a region in which coal deposits of possible economic value occur
L.CONT	kontinent	continent: Europe, Africa, Asia, North America, South America, Oceania, Antarctica
L.CST	kust	a zone of variable width straddling the shoreline
L.CTRB	affärscenter	a place where a number of businesses are located
L.DEVH	housing development	a tract of land on which many houses of similar design are built according to a development plan
L.FLD	fält	an open as opposed to wooded area
L.FLDI	(konst)bevattnade fält	a tract of level or terraced land which is irrigated
L.GASF	gasfält	an area containing a subterranean store of natural gas of economic value
L.GRAZ	betesområde	an area of grasses and shrubs used for grazing
L.GVL	grusområde	an area covered with gravel
L.INDS	industriområde	an area characterized by industrial activity
L.LAND	arktiskt land	a tract of land in the Arctic
L.LCTY	locality	a minor area or place of unspecified or mixed character and indefinite boundaries
L.MILB	militärbas	a place used by an army or other armed service for storing arms and supplies, and for accommodating and training troops, a base from which operations can be initiated
L.MNA	gruvområde	an area of mine sites where minerals and ores are extracted
L.MVA	maneuver area	a tract of land where military field exercises are carried out
L.NVB	marinbas	an area used to store supplies, provide barracks for troops and naval personnel, a port for naval vessels, and from which operations are initiated
L.OAS	oas(er)	an area in a desert made productive by the availability of water
L.OILF	oljefält	an area containing a subterranean store of petroleum of economic value
L.PEAT	torvfält	an area where peat is harvested
L.PRK	park	an area, often of forested land, maintained as a place of beauty, or for recreation
L.PRT	hamn	a place provided with terminal and transfer facilities for loading and discharging waterborne cargo or passengers, usually located in a harbor
L.QCKS	kvicksand	an area where loose sand with water moving through it may become unstable when heavy objects are placed at the surface, causing them to sink
L.RES	reservat	a tract of public land reserved for future use or restricted as to use
L.RESA	jordbruksreservat	a tract of land reserved for agricultural reclamation and/or development
L.RESF	skogsreservat	a forested area set aside for preservation or controlled use
L.RESH	jaktreservat	a tract of land used primarily for hunting
L.RESN	naturreservat	an area reserved for the maintenance of a natural habitat
L.RESP	palmträdsreservat	an area of palm trees where use is controlled
L.RESV	reservat	a tract of land set aside for aboriginal, tribal, or native populations
L.RESW	viltreservat	a tract of public land reserved for the preservation of wildlife
L.RGN	region	an area distinguished by one or more observable physical or cultural characteristics
L.RGNE	ekonomisk region	a region of a country established for economic development or for statistical purposes
L.RGNH	historical region	a former historic area distinguished by one or more observable physical or cultural characteristics
L.RGNL	sjöregion	a tract of land distinguished by numerous lakes
L.RNGA	skjutfält	a tract of land used for artillery firing practice
L.SALT	saltområde	a shallow basin or flat where salt accumulates after periodic inundation
L.SNOW	snöfält	an area of permanent snow and ice forming the accumulation area of a glacier
L.TRB	stamområde	a tract of land used by nomadic or other tribes
P.PPL	befolkad plats	a city, town, village, or other agglomeration of buildings where people live and work
P.PPLA	säte för en första ordningens administrativ enhet	seat of a first-order administrative division (PPLC takes precedence over PPLA)
P.PPLA2	seat of a second-order administrative division	
P.PPLA3	seat of a third-order administrative division	
P.PPLA4	seat of a fourth-order administrative division	
P.PPLC	huvudstad i politisk enhet	
P.PPLCH	historical capital of a political entity	a former capital of a political entity
P.PPLF	farm village	a populated place where the population is largely engaged in agricultural activities
P.PPLG	säte av ledningen för en politisk enhet	
P.PPLH	historical populated place	a populated place that no longer exists
P.PPLL	befolkad ort	an area similar to a locality but with a small group of dwellings or other buildings
P.PPLQ	tidigare befolkad plats	
P.PPLR	religiös befolkad plats	a populated place whose population is largely engaged in religious occupations
P.PPLS	befolkade platser	cities, towns, villages, or other agglomerations of buildings where people live and work
P.PPLW	förstörd befolkad plats	a village, town or city destroyed by a natural disaster, or by war
P.PPLX	del av befolkad plats	
P.STLMT	israelisk bosättning	
R.CSWY	broväg, höjd gångbana	a raised roadway across wet ground or shallow water
R.OILP	oljepipeline	a pipeline used for transporting oil
R.PRMN	promenad	a place for public walking, usually along a beach front
R.PTGE	portage	a place where boats, goods, etc., are carried overland between navigable waters
R.RD	väg	an open way with improved surface for transportation of animals, people and vehicles
R.RDA	historisk väg	the remains of a road used by ancient cultures
R.RDB	vägkrök	a conspicuously curved or bent section of a road
R.RDCUT	road cut	an excavation cut through a hill or ridge for a road
R.RDJCT	vägknytpunkt	a place where two or more roads join
R.RJCT	järnvägsknytpunkt	a place where two or more railroad tracks join
R.RR	järnväg	a permanent twin steel-rail track on which freight and passenger cars move long distances
R.RRQ	övergiven järnväg	
R.RTE	karavanväg	the route taken by caravans
R.RYD	railroad yard	a system of tracks used for the making up of trains, and switching and storing freight cars
R.ST	väg	a paved urban thoroughfare
R.STKR	boskapsled	a route taken by livestock herds
R.TNL	tunnel	a subterranean passageway for transportation
R.TNLN	naturlig tunnel	a cave that is open at both ends
R.TNLRD	vägtunnel	a tunnel through which a road passes
R.TNLRR	järnvägstunnel	a tunnel through which a railroad passes
R.TNLS	tunnlar	subterranean passageways for transportation
R.TRL	spår, stig	a path, track, or route used by pedestrians, animals, or off-road vehicles
S.ADMF	administrativ inrättning	a government building
S.AGRF	jordbruksinrättning	a building and/or tract of land used for improving agriculture
S.AIRB	flygbas	an area used to store supplies, provide barracks for air force personnel, hangars and runways for aircraft, and from which operations are initiated
S.AIRF	flygfält	a place on land where aircraft land and take off; no facilities provided for the commercial handling of passengers and cargo
S.AIRH	landningsplats för helikopter	a place where helicopters land and take off
S.AIRP	flygplats	a place where aircraft regularly land and take off, with runways, navigational aids, and major facilities for the commercial handling of passengers and cargo
S.AIRQ	övergivet flygfält	
S.AMTH	amfiteater	an oval or circular structure with rising tiers of seats about a stage or open space
S.ANS	forntida lämning	a place where archeological remains, old structures, or cultural artifacts are located
S.AQC	aquaculture facility	facility or area for the cultivation of aquatic animals and plants, especially fish, shellfish, and seaweed, in natural or controlled marine or freshwater environments; underwater agriculture
S.ARCH	båge, valv	a natural or man-made structure in the form of an arch
S.ASTR	astronomisk station	a point on the earth whose position has been determined by observations of celestial bodies
S.ASYL	mentalsjukhus	a facility where the insane are cared for and protected
S.ATHF	idrottsfält	a tract of land used for playing team sports, and athletic track and field events
S.ATM	bankomat	An unattended electronic machine in a public place, connected to a data system and related equipment and activated by a bank customer to obtain cash withdrawals and other banking services. 
S.BANK	bank	A business establishment in which money is kept for saving or commercial purposes or is invested, supplied for loans, or exchanged. 
S.BCN	båk, fyrtorn	a fixed artificial navigation mark
S.BDG	bro	a structure erected across an obstacle such as a stream, road, etc., in order to carry roads, railroads, and pedestrians across
S.BDGQ	raserad bro	a destroyed or decayed bridge which is no longer functional
S.BLDG	byggnad	a structure built for permanent use, as a house, factory, etc.
S.BLDO	office building	commercial building where business and/or services are conducted
S.BP	gränsmärke	a fixture marking a point along a boundary
S.BRKS	kaserner	a building for lodging military personnel
S.BRKW	vågbrytare	a structure erected to break the force of waves at the entrance to a harbor or port
S.BSTN	baling station	a facility for baling agricultural products
S.BTYD	skeppsvarv	a waterside facility for servicing, repairing, and building small vessels
S.BUR	begravningsgrotta(or)	a cave used for human burials
S.BUSTN	Busstation	a facility comprising ticket office, platforms, etc. for loading and unloading passengers 
S.BUSTP	Busshållplats	a place lacking station facilities
S.CARN	stenkummel	a heap of stones erected as a landmark or for other purposes
S.CAVE	grotta(or)	an underground passageway or chamber, or cavity on the side of a cliff
S.CH	kyrka	a building for public Christian worship
S.CMP	läger	a site occupied by tents, huts, or other shelters for temporary use
S.CMPL	logging camp	a camp used by loggers
S.CMPLA	arbetsläger	a camp used by migrant or temporary laborers
S.CMPMN	gruvläger	a camp used by miners
S.CMPO	oljeläger	a camp used by oilfield workers
S.CMPQ	övergivet läger	
S.CMPRF	flyktingläger	a camp used by refugees
S.CMTY	kyrkogård	a burial place or ground
S.COMC	kommunikationscenter	a facility, including buildings, antennae, towers and electronic equipment for receiving and transmitting information
S.CRRL	fålla, inhägnad	a pen or enclosure for confining or capturing animals
S.CSNO	kasino	a building used for entertainment, especially gambling
S.CSTL	slott	a large fortified building or set of buildings
S.CSTM	tullhus	a building in a port where customs and duties are paid, and where vessels are entered and cleared
S.CTHSE	domstolsbyggnad	a building in which courts of law are held
S.CTRA	atomcentrum	a facility where atomic research is carried out
S.CTRCM	kulturcentrum	a facility for community recreation and other activities
S.CTRF	tjänstecentrum	a place where more than one facility is situated
S.CTRM	medicinskt center	a complex of health care buildings including two or more of the following: hospital, medical school, clinic, pharmacy, doctor's offices, etc.
S.CTRR	religiöst center	a facility where more than one religious activity is carried out, e.g., retreat, school, monastery, worship
S.CTRS	rymdcenter	a facility for launching, tracking, or controlling satellites and space vehicles
S.CVNT	kloster	a building where a community of nuns lives in seclusion
S.DAM	damm	a barrier constructed across a stream to impound water
S.DAMQ	förstörd damm	a destroyed or decayed dam which is no longer functional
S.DAMSB	underjordisk damm	a dam put down to bedrock in a sand river
S.DARY	mejeri	a facility for the processing, sale and distribution of milk or milk products
S.DCKD	torrdocka	a dock providing support for a vessel, and means for removing the water so that the bottom of the vessel can be exposed
S.DCKY	skeppsvarv	a facility for servicing, building, or repairing ships
S.DIKE	damm, fördämning, bank	an earth or stone embankment usually constructed for flood or stream control
S.DIP	diplomatic facility	office, residence, or facility of a foreign government, which may include an embassy, consulate, chancery, office of charge d'affaires, or other diplomatic, economic, military, or cultural mission
S.DPOF	bränsledepå	an area where fuel is stored
S.EST	egendom(ar)	a large commercialized agricultural landholding with associated buildings and other facilities
S.ESTO	oljepalmsplantage	an estate specializing in the cultivation of oil palm trees
S.ESTR	gummiplantage	an estate which specializes in growing and tapping rubber trees
S.ESTSG	sockerplantage	an estate that specializes in growing sugar cane
S.ESTT	teplantage	an estate which specializes in growing tea bushes
S.ESTX	del av egendom	
S.FCL	inrättning	a building or buildings housing a center, institute, foundation, hospital, prison, mission, courthouse, etc.
S.FNDY	gjuteri	a building or works where metal casting is carried out
S.FRM	farm	a tract of land with associated buildings devoted to agriculture
S.FRMQ	övergiven farm	
S.FRMS	farmer	tracts of land with associated buildings devoted to agriculture
S.FRMT	bondgård	the buildings and adjacent service areas of a farm
S.FT	fort	a defensive structure or earthworks
S.FY	färja	a boat or other floating conveyance and terminal facilities regularly used to transport people and vehicles across a waterbody
S.GATE	grind,port	a controlled access entrance or exit
S.GDN	trädgård(ar)	an enclosure for displaying selected plant or animal life
S.GHAT	ghat	a set of steps leading to a river, which are of religious significance, and at their base is usually a platform for bathing
S.GHSE	gästhus	a house used to provide lodging for paying guests
S.GOSP	gas och olje separator	a facility for separating gas from oil
S.GOVL	local government office	a facility housing local governmental offices, usually a city, town, or village hall
S.GRVE	grav	a burial site
S.HERM	eremitage	a secluded residence, usually for religious sects
S.HLT	halting place	a place where caravans stop for rest
S.HMSD	homestead	a residence, owner's or manager's, on a sheep or cattle station, woolshed, outcamp, or Aboriginal outstation, specific to Australia and New Zealand 
S.HSE	hus	a building used as a human habitation
S.HSEC	lantgods	a large house, mansion, or chateau, on a large estate
S.HSP	sjukhus	a building in which sick or injured, especially those confined to bed, are medically treated
S.HSPC	klinik	a medical facility associated with a hospital for outpatients
S.HSPD	klinik	a building where medical or dental aid is dispensed
S.HSPL	leprosarium	an asylum or hospital for lepers
S.HSTS	historisk plats	a place of historical importance
S.HTL	hotell	a building providing lodging and/or meals for the public
S.HUT	hydda	a small primitive house
S.HUTS	hyddor	small primitive houses
S.INSM	militär installation	a facility for use of and control by armed forces
S.ITTR	forskningsinstitut	a facility where research is carried out
S.JTY	pir,brygga	a structure built out into the water at a river mouth or harbor entrance to regulate currents and silting
S.LDNG	landstigning	a place where boats receive or discharge passengers and freight, but lacking most port facilities
S.LEPC	spetälskekoloni	a settled area inhabited by lepers in relative isolation
S.LIBR	bibliotek	A place in which information resources such as books are kept for reading, reference, or lending.
S.LNDF	landfill	a place for trash and garbage disposal in which the waste is buried between layers of earth to build up low-lying land
S.LOCK	sluss(ar)	a basin in a waterway with gates at each end by means of which vessels are passed from one water level to another
S.LTHSE	fyr	a distinctive structure exhibiting a major navigation light
S.MALL	köpcentrum	A large, often enclosed shopping complex containing various stores, businesses, and restaurants usually accessible by common passageways.
S.MAR	marina	a harbor facility for small boats, yachts, etc.
S.MFG	fabrik	one or more buildings where goods are manufactured, processed or fabricated
S.MFGB	bryggeri	one or more buildings where beer is brewed
S.MFGC	konservfabrik	a building where food items are canned
S.MFGCU	kopparbruk	a facility for processing copper ore
S.MFGLM	kalkugn	a furnace in which limestone is reduced to lime
S.MFGM	ammunitionsfabrik	a factory where ammunition is made
S.MFGPH	fosfatfabrik	a facility for producing fertilizer
S.MFGQ	övergiven fabrik	
S.MFGSG	sockerbruk, sockerraffinaderi	a facility for converting raw sugar into refined sugar
S.MKT	marknad	a place where goods are bought and sold at regular intervals
S.ML	kvarn	a building housing machines for transforming, shaping, finishing, grinding, or extracting products
S.MLM	malmförädling	a facility for improving the metal content of ore by concentration
S.MLO	olivoljebruk	a mill where oil is extracted from olives
S.MLSG	sockerbruk, sockerraffinaderi	a facility where sugar cane is processed into raw sugar
S.MLSGQ	tidigare sockerbruk	a sugar mill no longer used as a sugar mill
S.MLSW	sågverk	a mill where logs or lumber are sawn to specified shapes and sizes
S.MLWND	väderkvarn	a mill or water pump powered by wind
S.MLWTR	vattenkvarn	a mill powered by running water
S.MN	gruva(or)	a site where mineral ores are extracted from the ground by excavating surface pits and subterranean passages
S.MNAU	guldgruva(or)	a mine where gold ore, or alluvial gold is extracted
S.MNC	kolgruva(or)	a mine where coal is extracted
S.MNCR	kromgruva(or)	a mine where chrome ore is extracted
S.MNCU	koppargruva(or)	a mine where copper ore is extracted
S.MNFE	järngruva(or)	a mine where iron ore is extracted
S.MNMT	monument	a commemorative structure or statue
S.MNN	saltgruva(or)	a mine from which salt is extracted
S.MNQ	övergiven gruva	
S.MNQR	stenbrott	a surface mine where building stone or gravel and sand, etc. are extracted
S.MOLE	pir, vågbrytare	a massive structure of masonry or large stones serving as a pier or breakwater
S.MSQE	moské	a building for public Islamic worship
S.MSSN	beskickning	a place characterized by dwellings, school, church, hospital and other facilities operated by a religious group for the purpose of providing charitable services and to propagate religion
S.MSSNQ	övergiven beskickning	
S.MSTY	munkkloster	a building and grounds where a community of monks lives in seclusion
S.MTRO	tunnelbanestation	metro station (Underground, Tube, or Metro) 
S.MUS	museum	a building where objects of permanent interest in one or more of the arts and sciences are preserved and exhibited
S.NOV	novitiat	a religious house or school where novices are trained
S.NSY	plantskola	a place where plants are propagated for transplanting or grafting
S.OBPT	observationspunkt	a wildlife or scenic observation point
S.OBS	observatorium	a facility equipped for observation of atmospheric or space phenomena
S.OBSR	radioobservatorium	a facility equipped with an array of antennae for receiving radio waves from space
S.OILJ	knutpunkt för oljepipeline	a section of an oil pipeline where two or more pipes join together
S.OILQ	övergiven oljekälla	
S.OILR	oljeraffinaderi	a facility for converting crude oil into refined petroleum products
S.OILT	depå	a tract of land occupied by large, cylindrical, metal tanks in which oil or liquid petrochemicals are stored
S.OILW	oljekälla	a well from which oil may be pumped
S.OPRA	operahus	A theater designed chiefly for the performance of operas.
S.PAL	palats	a large stately house, often a royal or presidential residence
S.PGDA	pagod	a tower-like storied structure, usually a Buddhist shrine
S.PIER	pir, kaj, vågbrytare	a structure built out into navigable water on piles providing berthing for ships and recreation
S.PKLT	parkerginsplats	an area used for parking vehicles
S.PMPO	pumpstation för olja	a facility for pumping oil through a pipeline
S.PMPW	pumpstation för vatten	a facility for pumping water from a major well or through a pipeline
S.PO	postkontor	a public building in which mail is received, sorted and distributed
S.PP	polispostering	a building in which police are stationed
S.PPQ	övergiven polispostering	
S.PRKGT	parkingång	a controlled access to a park
S.PRKHQ	park huvudkontor	a park administrative facility
S.PRN	fängelse	a facility for confining prisoners
S.PRNJ	uppfostringsanstalt	a facility for confining, training, and reforming young law offenders
S.PRNQ	övergivet fängelse	
S.PS	kraftstation	a facility for generating electric power
S.PSH	vattenkraftstation	a building where electricity is generated from water power
S.PSTB	gränspostering	a post or station at an international boundary for the regulation of movement of people and goods
S.PSTC	tullpostering	a building at an international boundary where customs and duties are paid on goods
S.PSTP	patrullpostering	a post from which patrols are sent out
S.PYR	pyramid	an ancient massive structure of square ground plan with four triangular faces meeting at a point and used for enclosing tombs
S.PYRS	pyramider	ancient massive structures of square ground plan with four triangular faces meeting at a point and used for enclosing tombs
S.QUAY	kaj	a structure of solid construction along a shore or bank which provides berthing for ships and which generally provides cargo handling facilities
S.RDCR	traffic circle	a road junction formed around a central circle about which traffic moves in one direction only
S.RECG	golfbana	a recreation field where golf is played
S.RECR	kapplöpningsbana	a track where races are held
S.REST	restaurang	A place where meals are served to the public
S.RET	store	a building where goods and/or services are offered for sale
S.RHSE	härbärge, vilohem	a structure maintained for the rest and shelter of travelers
S.RKRY	djurkoloni	a breeding place of a colony of birds or seals
S.RLG	religiös plats	an ancient site of significant religious importance
S.RLGR	fristad, tillflyktsort	a place of temporary seclusion, especially for religious groups
S.RNCH	ranch(er)	a large farm specializing in extensive grazing of livestock
S.RSD	järnvägsstickspår	a short track parallel to and joining the main track
S.RSGNL	järnvägssignal	a signal at the entrance of a particular section of track governing the movement of trains
S.RSRT	semesterort	a specialized facility for vacation, health, or participation sports activities
S.RSTN	järnvägsstation	a facility comprising ticket office, platforms, etc. for loading and unloading train passengers and freight
S.RSTNQ	övergiven järnvägsstation	
S.RSTP	järnvägsstopp	a place lacking station facilities where trains stop to pick up and unload passengers and freight
S.RSTPQ	övergivet järnvägsstopp	
S.RUIN	ruin(er)	a destroyed or decayed structure which is no longer functional
S.SCH	skola	building(s) where instruction in one or more branches of knowledge takes place
S.SCHA	jordbruksskola	a school with a curriculum focused on agriculture
S.SCHC	universitet	the grounds and buildings of an institution of higher learning
S.SCHL	Språkskola	Language Schools & Institutions
S.SCHM	militärskola	a school at which military science forms the core of the curriculum
S.SCHN	sjöfartsskola	a school at which maritime sciences form the core of the curriculum
S.SCHT	technical school	post-secondary school with a specifically technical or vocational curriculum
S.SECP	State Exam Prep Centre	state exam preparation centres
S.SHPF	fårfälla	a fence or wall enclosure for sheep and other small herd animals
S.SHRN	helgedom	a structure or place memorializing a person or religious concept
S.SHSE	magasin	a building for storing goods, especially provisions
S.SLCE	sluss	a conduit or passage for carrying off surplus water from a waterbody, usually regulated by means of a sluice gate
S.SNTR	sanatorium	a facility where victims of physical or mental disorders are treated
S.SPA	bad	a resort area usually developed around a medicinal spring
S.SPLY	dammavlopp	a passage or outlet through which surplus water flows over, around or through a dam
S.SQR	torg	a broad, open, public area near the center of a town or city
S.STBL	stall	a building for the shelter and feeding of farm animals, especially horses
S.STDM	stadium	a structure with an enclosure for athletic games with tiers of seats for spectators
S.STNB	forskningsstation	a scientific facility used as a base from which research is carried out or monitored
S.STNC	kustvaktsstation	a facility from which the coast is guarded by armed vessels
S.STNE	experimentstation	a facility for carrying out experiments
S.STNF	skogsstation	a collection of buildings and facilities for carrying out forest management
S.STNI	inspektionsstation	a station at which vehicles, goods, and people are inspected
S.STNM	meteorologisk station	a station at which weather elements are recorded
S.STNR	radiostation	a facility for producing and transmitting information by radio waves
S.STNS	satellitstation	a facility for tracking and communicating with orbiting satellites
S.STNW	valstation	a facility for butchering whales and processing train oil
S.STPS	trappa	stones or slabs placed for ease in ascending or descending a steep slope
S.SWT	sewage treatment plant	facility for the processing of sewage and/or wastewater
S.THTR	teater	A building, room, or outdoor structure for the presentation of plays, films, or other dramatic performances
S.TMB	grav(ar)	a structure for interring bodies
S.TMPL	tempel	an edifice dedicated to religious worship
S.TNKD	cattle dipping tank	a small artificial pond used for immersing cattle in chemically treated water for disease control
S.TOWR	torn	a high conspicuous structure, typically much higher than its diameter
S.TRANT	transit terminal	facilities for the handling of vehicular freight and passengers
S.TRIG	trianguleringsstation	a point on the earth whose position has been determined by triangulation
S.TRMO	oljepipelineterminal	a tank farm or loading facility at the end of an oil pipeline
S.TWO	Temp Work Office	Temporary Work Offices
S.UNIP	University Prep School	University Preparation Schools & Institutions
S.UNIV	universitet	An institution for higher learning with teaching and research facilities constituting a graduate school and professional schools that award master's degrees and doctorates and an undergraduate division that awards bachelor's degrees.
S.USGE	amerikansk regeringsbyggnad	a facility operated by the United States Government in Panama
S.VETF	veterinärklinik	a building or camp at which veterinary services are available
S.WALL	mur	a thick masonry structure, usually enclosing a field or building, or forming the side of a structure
S.WALLA	historisk damm	the remains of a linear defensive stone structure
S.WEIR	damm, fördämning	a small dam in a stream, designed to raise the water level or to divert stream flow through a desired channel
S.WHRF	kaj, brygga	a structure of open rather than solid construction along a shore or a bank which provides berthing for ships and cargo-handling facilities
S.WRCK	vrak	the site of the remains of a wrecked vessel
S.WTRW	vattenverk, vattenkonst	a facility for supplying potable water through a water source and a system of pumps and filtration beds
S.ZNF	frihandelszon	an area, usually a section of a port, where goods may be received and shipped free of customs duty and of most customs regulations
S.ZOO	zoo	a zoological garden or park where wild animals are kept for exhibition
T.ASPH	asfaltssjö	a small basin containing naturally occurring asphalt
T.ATOL	atoll(er)	a ring-shaped coral reef which has closely spaced islands on it encircling a lagoon
T.BAR	rev	a shallow ridge or mound of coarse unconsolidated material in a stream channel, at the mouth of a stream, estuary, or lagoon and in the wave-break zone along coasts
T.BCH	strand	a shore zone of coarse unconsolidated sediment that extends from the low-water line to the highest reach of storm waves
T.BCHS	stränder	a shore zone of coarse unconsolidated sediment that extends from the low-water line to the highest reach of storm waves
T.BDLD	ofruktbart land	an area characterized by a maze of very closely spaced, deep, narrow, steep-sided ravines, and sharp crests and pinnacles
T.BLDR	stenblocksfält	a high altitude or high latitude bare, flat area covered with large angular rocks
T.BLHL	blowhole(s)	a hole in coastal rock through which sea water is forced by a rising tide or waves and spurted through an outlet into the air
T.BLOW	utvidgning(ar)	a small depression in sandy terrain, caused by wind erosion
T.BNCH	avsats	a long, narrow bedrock platform bounded by steeper slopes above and below, usually overlooking a waterbody
T.BUTE	kulle	a small, isolated, usually flat-topped hill with steep sides
T.CAPE	udde, kap	a land area, more prominent than a point, projecting into the sea and marking a notable change in coastal direction
T.CFT	klyfta	a deep narrow slot, notch, or groove in a coastal cliff
T.CLDA	krater	a depression measuring kilometers across formed by the collapse of a volcanic mountain
T.CLF	brant klippa, stup	a high, steep to perpendicular slope overlooking a waterbody or lower area
T.CNYN	kanjon, djup flodbädd	a deep, narrow valley with steep sides cutting into a plateau or mountainous area
T.CONE	kon	a conical landform composed of mud or volcanic material
T.CRDR	korridor	a strip or area of land having significance as an access way
T.CRQ	kitteldal	a bowl-like hollow partially surrounded by cliffs or steep slopes at the head of a glaciated valley
T.CRQS	kitteldalar	bowl-like hollows partially surrounded by cliffs or steep slopes at the head of a glaciated valley
T.CRTR	krater	a generally circular saucer or bowl-shaped depression caused by volcanic or meteorite explosive action
T.CUET	backe	an asymmetric ridge formed on tilted strata
T.DLTA	delta	a flat plain formed by alluvial deposits at the mouth of a stream
T.DPR	depression(er)	a low area surrounded by higher land and usually characterized by interior drainage
T.DSRT	öken	a large area with little or no vegetation due to extreme environmental conditions
T.DUNE	sanddyn(er)	a wave form, ridge or star shape feature composed of sand
T.DVD	vattendelare	a line separating adjacent drainage basins
T.ERG	sandöken	an extensive tract of shifting sand and sand dunes
T.FAN	fan(s)	a fan-shaped wedge of coarse alluvium with apex merging with a mountain stream bed and the fan spreading out at a low angle slope onto an adjacent plain
T.FORD	vadställe	a shallow part of a stream which can be crossed on foot or by land vehicle
T.FSR	klyfta, spricka	a crack associated with volcanism
T.GAP	gap, öppning, hål, klyfta	a low place in a ridge, not used for transportation
T.GRGE	trång klyfta mellan berg	a short, narrow, steep-sided section of a stream valley
T.HDLD	halvö,udde	a high projection of land extending into a large body of water beyond the line of the coast
T.HLL	kulle	a rounded elevation of limited extent rising above the surrounding land with local relief of less than 300m
T.HLLS	kullar	rounded elevations of limited extent rising above the surrounding land with local relief of less than 300m
T.HMCK	hammock	a patch of ground, distinct from and slightly above the surrounding plain or wetland. Often occurs in groups
T.HMDA	klippöken	a relatively sand-free, high bedrock plateau in a hot desert, with or without a gravel veneer
T.INTF	interfluve	a relatively undissected upland between adjacent stream valleys
T.ISL	ö	a tract of land, smaller than a continent, surrounded by water at high water
T.ISLET	islet	small island, bigger than rock, smaller than island.
T.ISLF	artificiell ö	an island created by landfill or diking and filling in a wetland, bay, or lagoon
T.ISLM	mangrove ö	a mangrove swamp surrounded by a waterbody
T.ISLS	öar	tracts of land, smaller than a continent, surrounded by water at high water
T.ISLT	halvö	a coastal island connected to the mainland by barrier beaches, levees or dikes
T.ISLX	del av ö	
T.ISTH	näs	a narrow strip of land connecting two larger land masses and bordered by water
T.KRST	karstområde	a distinctive landscape developed on soluble rock such as limestone characterized by sinkholes, caves, disappearing streams, and underground drainage
T.LAVA	lavaområde	an area of solidified lava
T.LEV	skyddsvall	a natural low embankment bordering a distributary or meandering stream; often built up artificially to control floods
T.MESA	platå(er)	a flat-topped, isolated elevation with steep slopes on all sides, less extensive than a plateau
T.MND	höjd(er)	a low, isolated, rounded hill
T.MRN	morän	a mound, ridge, or other accumulation of glacial till
T.MT	berg	an elevation standing high above the surrounding area with small summit area, steep slopes and local relief of 300m or more
T.MTS	berg	a mountain range or a group of mountains or high ridges
T.NKM	meander neck	a narrow strip of land between the two limbs of a meander loop at its narrowest point
T.NTK	nunatak	a rock or mountain peak protruding through glacial ice
T.NTKS	nunataker	rocks or mountain peaks protruding through glacial ice
T.PAN	sänka	a near-level shallow, natural depression or basin, usually containing an intermittent lake, pond, or pool
T.PANS	sänkor	a near-level shallow, natural depression or basin, usually containing an intermittent lake, pond, or pool
T.PASS	bergspass, trång väg(passage)	a break in a mountain range or other high obstruction, used for transportation from one side to the other [See also gap]
T.PEN	halvö	an elongate area of land projecting into a body of water and nearly surrounded by water
T.PENX	del av halvö	
T.PK	topp	a pointed elevation atop a mountain, ridge, or other hypsographic feature
T.PKS	toppar	pointed elevations atop a mountain, ridge, or other hypsographic features
T.PLAT	platå	an elevated plain with steep slopes on one or more sides, and often with incised streams
T.PLATX	del av platå	
T.PLDR	invallat landområde	an area reclaimed from the sea by diking and draining
T.PLN	slätt(land)	an extensive area of comparatively level to gently undulating land, lacking surface irregularities, and usually adjacent to a higher area
T.PLNX	del av slättland	
T.PROM	hög udde	a bluff or prominent hill overlooking or projecting into a lowland
T.PT	udde	a tapering piece of land projecting into a body of water, less prominent than a cape
T.PTS	uddar	tapering pieces of land projecting into a body of water, less prominent than a cape
T.RDGB	bergskam	a ridge of sand just inland and parallel to the beach, usually in series
T.RDGE	rygg, kam, ås	a long narrow elevation with steep sides, and a more or less continuous crest
T.REG	stenöken	a desert plain characterized by a surface veneer of gravel and stones
T.RK	klippa	a conspicuous, isolated rocky mass
T.RKFL	ras	an irregular mass of fallen rock at the base of a cliff or steep slope
T.RKS	klippor	conspicuous, isolated rocky masses
T.SAND	sandområde	a tract of land covered with sand
T.SBED	uttorkad flodbädd	a channel formerly containing the water of a stream
T.SCRP	brant sluttning	a long line of cliffs or steep slopes separating level surfaces above and below
T.SDL	sadelformad bergsrygg	a broad, open pass crossing a ridge or between hills or mountains
T.SHOR	kust, strand	a narrow zone bordering a waterbody which covers and uncovers at high and low water, respectively
T.SINK	sänka	a small crater-shape depression in a karst area
T.SLID	kana	a mound of earth material, at the base of a slope and the associated scoured area
T.SLP	sluttning	a surface with a relatively uniform slope angle
T.SPIT	landtunga	a narrow, straight or curved continuation of a beach into a waterbody
T.SPUR	utlöpare	a subordinate ridge projecting outward from a hill, mountain or other elevation
T.TAL	stenrassluttning	a steep concave slope formed by an accumulation of loose rock fragments at the base of a cliff or steep slope
T.TRGD	ränna mellan dyner	a long wind-swept trough between parallel longitudinal dunes
T.TRR	terass	a long, narrow alluvial platform bounded by steeper slopes above and below, usually overlooking a waterbody
T.UPLD	högland	an extensive interior region of high land with low to moderate surface relief
T.VAL	dal	an elongated depression usually traversed by a stream
T.VALG	hängdal	a valley the floor of which is notably higher than the valley or shore to which it leads; most common in areas that have been glaciated
T.VALS	dalar	elongated depressions usually traversed by a stream
T.VALX	del av dal	
T.VLC	vulkan	a conical elevation composed of volcanic materials with a crater at the top
U.APNU	plattform	a gentle slope, with a generally smooth surface, particularly found around groups of islands and seamounts
U.ARCU	båge, valv	a low bulge around the southeastern end of the island of Hawaii
U.ARRU	veckig	an area of subdued corrugations off Baja California
U.BDLU	gränsland	a region adjacent to a continent, normally occupied by or bordering a shelf, that is highly irregular with depths well in excess of those typical of a shelf
U.BKSU	strandsluttningar	elevations, typically located on a shelf, over which the depth of water is relatively shallow but sufficient for safe surface navigation
U.BNKU	strandsluttning, vall	an elevation, typically located on a shelf, over which the depth of water is relatively shallow but sufficient for safe surface navigation
U.BSNU	sänka, bassäng	a depression more or less equidimensional in plan and of variable extent
U.CDAU	bergskedja	an entire mountain system including the subordinate ranges, interior plateaus, and basins
U.CNSU	kanjoner	relatively narrow, deep depressions with steep sides, the bottom of which generally has a continuous slope
U.CNYU	kanjon	a relatively narrow, deep depression with steep sides, the bottom of which generally has a continuous slope
U.CRSU	kontinentalhöjning	a gentle slope rising from oceanic depths towards the foot of a continental slope
U.DEPU	djup	a localized deep area within the confines of a larger feature, such as a trough, basin or trench
U.EDGU	shelf edge	a line along which there is a marked increase of slope at the outer margin of a continental shelf or island shelf
U.ESCU	brant sluttning	an elongated and comparatively steep slope separating flat or gently sloping areas
U.FANU	fan	a relatively smooth feature normally sloping away from the lower termination of a canyon or canyon system
U.FLTU	flat	a small level or nearly level area
U.FRZU	fracture zone	an extensive linear zone of irregular topography of the sea floor, characterized by steep-sided or asymmetrical ridges, troughs, or escarpments
U.FURU	spår	a closed, linear, narrow, shallow depression
U.GAPU	klyfta	a narrow break in a ridge or rise
U.GLYU	ravin	a small valley-like feature
U.HLLU	kulle	an elevation rising generally less than 500 meters
U.HLSU	kullar	elevations rising generally less than 500 meters
U.HOLU	hål	a small depression of the sea floor
U.KNLU	liten kulle	an elevation rising generally more than 500 meters and less than 1,000 meters and of limited extent across the summit
U.KNSU	små kullar	elevations rising generally more than 500 meters and less than 1,000 meters and of limited extent across the summits
U.LDGU	klippavsats	a rocky projection or outcrop, commonly linear and near shore
U.LEVU	damm	an embankment bordering a canyon, valley, or seachannel
U.MESU	högplatå	an isolated, extensive, flat-topped elevation on the shelf, with relatively steep sides
U.MNDU	gravkulle	a low, isolated, rounded hill
U.MOTU	vallgrav	an annular depression that may not be continuous, located at the base of many seamounts, islands, and other isolated elevations
U.MTU	berg	a well-delineated subdivision of a large and complex positive feature
U.PKSU	toppar	prominent elevations, part of a larger feature, either pointed or of very limited extent across the summit
U.PKU	topp	a prominent elevation, part of a larger feature, either pointed or of very limited extent across the summit
U.PLNU	slätt(land)	a flat, gently sloping or nearly level region
U.PLTU	platå	a comparatively flat-topped feature of considerable extent, dropping off abruptly on one or more sides
U.PNLU	klippa	a high tower or spire-shaped pillar of rock or coral, alone or cresting a summit
U.PRVU	provins	a region identifiable by a group of similar physiographic features whose characteristics are markedly in contrast with surrounding areas
U.RDGU	ås	a long narrow elevation with steep sides
U.RDSU	åsar	long narrow elevations with steep sides
U.RFSU	rev	surface-navigation hazards composed of consolidated material
U.RFU	rev	a surface-navigation hazard composed of consolidated material
U.RISU	höjd	a broad elevation that rises gently, and generally smoothly, from the sea floor
U.SCNU	havskanal	a continuously sloping, elongated depression commonly found in fans or plains and customarily bordered by levees on one or two sides
U.SCSU	havskanaler	continuously sloping, elongated depressions commonly found in fans or plains and customarily bordered by levees on one or two sides
U.SDLU	sadelformad bergsrygg	a low part, resembling in shape a saddle, in a ridge or between contiguous seamounts
U.SHFU	sandrev, klippavsats	a zone adjacent to a continent (or around an island) that extends from the low water line to a depth at which there is usually a marked increase of slope towards oceanic depths
U.SHLU	grund, sandrev	a surface-navigation hazard composed of unconsolidated material
U.SHSU	sandbankar	hazards to surface navigation composed of unconsolidated material
U.SHVU	shelf valley	a valley on the shelf, generally the shoreward extension of a canyon
U.SILU	tröskel	the low part of a gap or saddle separating basins
U.SLPU	sluttning	the slope seaward from the shelf edge to the beginning of a continental rise or the point where there is a general reduction in slope
U.SMSU	undervattensberg	elevations rising generally more than 1,000 meters and of limited extent across the summit
U.SMU	undervattensberg	an elevation rising generally more than 1,000 meters and of limited extent across the summit
U.SPRU	utlöpare	a subordinate elevation, ridge, or rise projecting outward from a larger feature
U.TERU	terass	a relatively flat horizontal or gently inclined surface, sometimes long and narrow, which is bounded by a steeper ascending slope on one side and by a steep descending slope on the opposite side
U.TMSU	undervattensberg	seamounts having a comparatively smooth, flat top
U.TMTU	undervattensberg	a seamount having a comparatively smooth, flat top
U.TNGU	landtunga	an elongate (tongue-like) extension of a flat sea floor into an adjacent higher feature
U.TRGU	ränna	a long depression of the sea floor characteristically flat bottomed and steep sided, and normally shallower than a trench
U.TRNU	dike	a long, narrow, characteristically very deep and asymmetrical depression of the sea floor, with relatively steep sides
U.VALU	dal	a relatively shallow, wide depression, the bottom of which usually has a continuous gradient
U.VLSU	dalar	a relatively shallow, wide depression, the bottom of which usually has a continuous gradient
V.BUSH	djungel	a small clump of conspicuous bushes in an otherwise bare area
V.CULT	uppodlat område	an area under cultivation
V.FRST	skog(ar)	an area dominated by tree vegetation
V.FRSTF	fossil skog	a forest fossilized by geologic processes and now exposed at the earth's surface
V.GRSLD	grässlätt	an area dominated by grass vegetation
V.GRVC	kokoslund	a planting of coconut trees
V.GRVO	olivlund	a planting of olive trees
V.GRVP	palmlund	a planting of palm trees
V.GRVPN	furulund	a planting of pine trees
V.HTH	hed	an upland moor or sandy area dominated by low shrubby vegetation including heather
V.MDW	äng	a small, poorly drained area dominated by grassy vegetation
V.OCH	fruktträdgård(ar)	a planting of fruit or nut trees
V.SCRB	buskterräng	an area of low trees, bushes, and shrubs stunted by some environmental limitation
V.TREE	träd	a conspicuous tree used as a landmark
V.TUND	tundra	a marshy, treeless, high latitude plain, dominated by mosses, lichens, and low shrub vegetation under permafrost conditions
V.VIN	vingård	a planting of grapevines
V.VINS	vingårdar	plantings of grapevines
null	not available	
